5 10
|--------|
|.FC|..-P|
|..-|.@..|
|.F....-.|
|--------|